b,b,b,2,2,2,b,b,b,
b,b,b,1,1,1,b,b,b,
b,b,b,3,3,3,b,b,b,
b,b,b,b,b,2,2,2,b,
b,b,b,b,b,b,b,2,b,
b,2,2,b,b,b,2,2,b,
b,b,2,2,2,2,2,b,b,
b,b,b,b,b,b,b,b,b,
b,b,b,b,b,b,b,b,b,